int map02[20][61] = {{219,219,219,219,219,219,219,219,219,219,219,219,219,219,219,219,219,219,219,219,219,219,219,219,219,219,219,219,219,219,219,219,219,219,219,219,219,219,219,219,219,219,219,219,219,219,219,219,219,219,219,219,219,219,219,219,219,219,219,219,219,},
		     {219,178,178,219,219,219,219,219,219,219,219,219,219,219,219,219,178,178,178,178,178,219,178,178,178,178,219,178,178,178,178,178,178,178,178,178,178,178,178,178,178,178,178,219,178,178,178,219,178,178,178,178,178,178,178,178,178,178,178,178,219,},
		     {219,176,176,219,219,219,219,219,219,219,219,219,219,219,219,219,176,176,176,176,176,219,176,176,176,176,219,176,176,176,176,176,176,176,176,176,176,176,176,176,176,176,176,219,176,176,176,178,176,176,176,176,176,176,176,176,176,176,176,176,219,},
		     {219,176,176,178,178,178,178,178,178,178,178,178,178,178,178,219,219,219,219,219,219,219,176,176,176,176,178,176,176,176,176,176,176,176,176,176,176,176,176,176,176,176,176,219,176,176,176,176,176,176,176,176,176,176,176,176,219,176,176,176,219,},
		     {219,176,176,176,176,176,176,176,176,176,176,176,176,176,176,219,178,178,178,178,178,219,176,176,176,176,176,176,176,219,176,176,176,176,176,176,176,176,176,176,219,176,176,219,176,176,176,219,176,176,176,176,176,176,176,176,219,176,176,176,219,},
		     {219,176,176,219,176,176,219,176,176,219,176,176,219,176,176,219,176,176,176,176,176,219,219,219,219,219,219,176,176,178,176,176,176,176,176,176,176,176,176,176,178,176,176,219,176,176,176,219,176,176,176,176,176,176,176,176,219,176,176,176,219,},
		     {219,176,176,178,176,176,178,176,176,178,176,176,178,176,176,178,176,176,176,176,176,219,178,178,178,178,219,176,176,176,176,176,176,176,176,176,176,176,176,176,176,176,176,219,176,176,176,219,219,219,219,219,219,219,219,219,219,176,176,176,219,},
		     {219,176,176,176,176,176,176,176,176,176,176,176,176,176,176,176,176,176,176,176,176,219,176,176,176,176,219,176,176,176,176,176,176,176,176,176,176,176,176,176,176,176,176,219,176,176,176,178,178,178,178,178,178,178,178,178,219,176,176,176,219,},
		     {219,176,176,219,176,176,219,176,176,219,176,176,219,176,176,219,176,176,176,176,176,219,176,176,176,176,219,176,176,176,176,176,176,176,176,176,176,176,176,176,176,176,176,219,176,176,176,176,176,176,176,176,176,176,176,176,219,176,176,176,219,},
		     {219,176,176,178,176,176,178,176,176,178,176,176,178,176,176,219,176,176,176,176,176,219,176,176,176,176,219,176,176,176,176,176,176,176,176,176,176,176,176,176,176,176,176,219,176,176,176,176,176,176,176,176,176,176,176,176,219,176,176,176,219,},
		     {219,176,176,176,176,176,176,176,176,176,176,176,176,176,176,219,176,176,176,176,176,219,176,176,176,176,219,176,176,176,176,176,176,176,176,176,176,176,176,176,176,176,176,219,219,219,176,219,219,219,219,219,219,219,219,219,219,176,176,176,219,},
		     {219,219,219,219,219,219,219,219,219,219,219,219,219,219,219,219,219,219,219,176,176,219,176,176,176,176,219,176,176,176,176,176,176,176,176,176,176,176,176,176,176,176,176,219,178,178,176,178,178,178,178,178,178,178,178,178,219,176,176,176,219,},
		     {219,178,178,178,178,178,178,178,178,178,178,178,178,178,178,178,178,178,178,176,176,219,176,176,176,176,219,176,176,176,176,176,176,176,176,176,176,176,176,176,176,176,176,219,176,176,176,176,176,176,176,176,176,176,176,176,219,176,176,176,219,},
		     {219,176,176,176,176,176,176,176,176,176,176,176,176,176,176,176,176,176,176,176,176,219,176,176,176,176,219,176,176,176,176,176,176,176,176,176,176,176,176,176,176,176,176,219,176,176,176,176,176,176,176,176,176,176,176,176,219,176,176,176,219,},
		     {219,176,176,176,176,176,176,176,176,176,176,176,176,176,176,176,176,176,176,176,176,219,176,176,176,176,178,176,176,176,176,176,176,176,176,176,176,176,176,176,176,176,176,219,219,219,219,219,219,219,219,219,219,176,176,176,219,176,176,176,219,},
		     {219,176,176,219,219,219,219,219,219,219,219,219,219,219,219,219,219,219,219,219,219,219,176,176,176,176,176,176,176,176,176,176,176,176,176,176,176,176,176,176,176,176,176,219,178,178,178,178,178,178,178,178,178,176,176,176,219,176,176,176,219,},
		     {219,176,176,178,178,178,178,178,178,178,178,178,178,178,178,178,178,178,178,178,178,178,176,176,176,176,219,176,176,219,176,176,176,219,219,176,219,219,176,176,219,176,176,178,176,176,176,176,176,176,176,176,176,176,176,176,219,176,176,176,219,},
		     {219,176,176,176,176,176,176,176,176,176,176,176,176,176,176,176,176,176,176,176,176,176,176,176,176,176,219,176,176,178,176,176,176,219,178,176,178,219,176,176,178,176,176,176,176,176,176,176,176,176,176,176,176,176,176,176,219,176,176,176,219,},
		     {219,176,176,176,176,176,176,176,176,176,176,176,176,176,176,176,176,176,176,176,176,219,176,176,176,176,219,176,176,176,176,176,176,219,176,176,176,219,176,176,176,176,176,219,176,176,176,176,176,176,176,176,176,176,176,176,219,176,176,176,219,},
		     {219,219,219,219,219,219,219,219,219,219,219,219,219,219,219,219,219,219,219,219,219,219,219,219,219,219,219,219,219,219,219,219,219,219,219,219,219,219,219,219,219,219,219,219,219,219,219,219,219,219,219,219,219,219,219,219,219,219,219,219,219,}};

map02[3][51] = ENEMY;
map02[17][53] = ENEMY;
map02[6][40] = ENEMY;
map02[3][35] = ENEMY;
map02[17][40] = ENEMY;
map02[12][35] = ENEMY;
map02[9][34] = ENEMY;
map02[6][29] = ENEMY;
map02[15][29] = ENEMY;
map02[12][24] = ENEMY;
map02[5][18] = ENEMY;
map02[2][44] = KEY;
map02[18][35] = KEY;
map02[7][22] = KEY;
map02[7][55] = LEVER_ON;
map02[17][36] = LEVER_ON;
map02[1][27] = LEVER_ON;
map02[1][23] = LEVER_ON;
map02[6][25] = LEVER_ON;
map02[9][44] = POTION;
map02[18][27] = POTION;
map02[17][43] = V_DOOR;
map02[17][21] = V_DOOR;
map02[4][26] = V_DOOR;
map02[10][46] = BARRIER;
map02[16][35] = BARRIER;
map02[15][26] = BARRIER;
map02[7][15] = BARRIER;
map02[2][16] = WEAPON;
map02[7][14] = NPC;
