int map01[20][61] = {{219,219,219,219,219,219,219,219,219,219,219,219,219,219,219,219,219,219,219,219,219,219,219,219,219,219,219,219,219,219,219,219,219,219,219,219,219,219,219,219,219,219,219,219,219,219,219,219,219,219,219,219,219,219,219,219,219,219,219,219,219,},
{219,178,178,178,178,178,219,178,178,178,178,178,178,178,178,178,219,178,178,178,178,178,178,219,178,178,178,178,178,178,178,178,178,178,178,178,178,178,178,219,178,178,178,178,178,178,178,178,178,219,178,178,219,178,178,178,178,178,178,178,219,},
{219,176,176,176,176,176,219,176,176,176,176,176,176,176,176,176,178,176,176,176,176,176,176,219,176,176,176,176,176,176,176,176,176,176,176,176,176,176,176,219,176,176,176,176,176,176,176,176,176,219,176,176,219,176,176,176,176,176,176,176,219,},
{219,176,176,176,176,176,176,176,176,176,219,176,176,176,176,176,176,176,176,176,176,176,176,219,176,176,219,219,219,219,219,219,219,219,219,176,176,176,176,219,176,176,176,176,219,176,176,176,176,219,176,176,178,176,176,176,176,176,176,176,219,},
{219,176,176,176,176,176,219,176,176,176,219,176,176,176,176,176,219,176,176,176,176,176,176,219,176,176,178,178,178,178,178,178,178,178,219,176,176,176,176,219,176,176,176,176,219,176,176,176,176,219,176,176,176,176,176,176,176,176,176,176,219,},
{219,219,219,219,219,219,219,176,176,176,219,176,176,176,176,176,219,176,176,176,176,176,176,219,176,176,176,176,176,176,176,176,176,176,219,176,176,176,176,219,176,176,176,176,219,176,176,176,176,219,219,219,219,219,219,219,219,219,219,176,219,},
{219,178,178,178,178,178,219,176,176,176,219,176,176,176,176,176,219,219,219,176,219,219,219,219,219,219,219,219,219,219,219,219,219,176,219,176,176,176,176,219,176,176,176,176,219,176,176,176,176,219,178,178,178,178,178,178,178,178,178,176,219,},
{219,176,176,176,176,176,219,176,176,176,219,176,176,176,176,176,219,178,178,176,178,178,178,178,178,178,178,178,178,178,178,219,178,176,219,176,176,176,176,219,176,176,176,176,219,176,176,176,176,219,176,176,176,176,176,176,176,176,176,176,219,},
{219,176,176,176,176,176,178,176,176,176,219,176,176,176,176,176,219,176,176,176,176,176,176,176,176,176,176,176,176,176,176,219,176,176,219,176,176,176,176,219,176,176,176,176,219,176,176,176,176,219,176,176,219,176,176,176,176,219,176,176,219,},
{219,176,176,176,176,176,176,176,176,176,219,176,176,176,176,176,219,176,176,219,176,176,176,176,176,176,176,176,219,176,176,219,176,176,219,176,176,176,176,219,176,176,176,176,219,176,176,176,176,219,176,176,178,176,176,176,176,178,176,176,219,},
{219,219,219,219,219,219,219,176,176,176,219,176,176,176,176,176,219,176,176,178,176,176,176,176,176,176,176,176,178,176,176,178,176,176,219,176,176,176,176,219,176,176,176,176,219,176,176,176,176,219,176,176,176,176,176,176,176,176,176,176,219,},
{219,178,178,178,178,178,219,176,176,176,219,176,176,176,176,176,219,176,176,176,176,176,176,176,176,176,176,176,176,176,176,176,176,176,219,176,176,176,176,219,176,176,176,176,219,176,176,176,176,219,176,176,176,176,176,176,176,176,176,176,219,},
{219,176,176,176,176,176,219,176,176,176,219,176,176,176,176,176,219,176,176,176,176,176,176,176,176,176,176,176,176,176,176,219,176,176,219,176,176,176,176,219,176,176,176,176,219,176,176,176,176,219,176,176,176,176,176,176,176,176,176,176,219,},
{219,176,176,176,176,176,176,176,176,176,219,176,176,176,176,176,219,176,176,176,176,176,176,176,176,176,176,176,176,176,176,219,219,219,219,219,219,176,219,219,219,219,176,219,219,219,219,176,219,219,176,176,219,176,176,176,176,219,176,176,219,},
{219,176,176,176,176,176,219,176,176,176,219,176,176,176,176,176,219,176,176,176,176,176,176,176,176,176,176,176,176,176,176,219,178,178,178,178,178,176,178,219,178,178,176,178,219,178,178,176,178,219,176,176,178,176,176,176,176,178,176,176,219,},
{219,219,219,219,219,219,219,176,176,176,219,219,219,219,176,176,219,176,176,176,176,176,176,176,176,176,176,176,176,176,176,219,176,176,176,176,176,176,176,219,176,176,176,176,219,176,176,176,176,219,176,176,176,176,176,176,176,176,176,176,219,},
{219,178,178,178,178,178,219,176,176,176,219,178,178,178,176,176,219,176,176,219,176,176,176,176,176,176,176,176,219,176,176,219,176,176,176,176,176,176,176,219,176,176,176,176,219,176,176,176,176,219,219,176,219,219,219,219,219,219,219,219,219,},
{219,176,176,176,176,176,178,176,176,176,219,176,176,176,176,176,219,176,176,178,176,176,176,176,176,176,176,176,178,176,176,219,176,176,176,176,176,176,176,219,176,176,176,176,219,176,176,176,176,178,178,176,178,178,178,178,178,178,178,178,219,},
{219,176,176,176,176,176,176,176,176,176,219,176,176,176,176,176,219,176,176,176,176,176,176,176,176,176,176,176,176,176,176,219,176,176,176,176,176,176,176,219,176,176,176,176,219,176,176,176,176,176,176,176,176,176,176,176,176,176,176,176,219,},
{219,219,219,219,219,219,219,219,219,219,219,219,219,219,219,219,219,219,219,219,219,219,219,219,219,219,219,219,219,219,219,219,219,219,219,219,219,219,219,219,219,219,219,219,219,219,219,219,219,219,219,219,219,219,219,219,219,219,219,219,219,}};

map01[13][6] = V_DOOR;
map01[3][6] = V_DOOR;
map01[6][19] = H_DOOR;
map01[6][33] = H_DOOR;
map01[16][39] = V_DOOR;
map01[13][47] = H_DOOR;
map01[16][51] = H_DOOR;
map01[3][2] = WEAPON;
map01[13][2] = POTION;
map01[14][11] = KEY;
map01[18][30] = KEY;
map01[12][35] = KEY;
map01[2][40] = KEY;
map01[18][45] = KEY;
map01[7][50] = KEY;
map01[16][11] = LEVER_ON;
map01[14][32] = LEVER_ON;
map01[17][59] = LEVER_ON;
map01[3][16] = BARRIER;
map01[13][42] = BARRIER;
map01[5][59] = BARRIER;
map01[10][14] = ENEMY;
map01[13][21] = ENEMY;
map01[12][28] = ENEMY;
map01[17][34] = ENEMY;
map01[7][47] = ENEMY;
map01[11][54] = ENEMY;
map01[8][2] = LORE;

int vert = 17;
int horz = 2;